111111111111111111
11CCPCCCCCCCCC1111
1000C00C1111111111
111111111111111111
111111111111111111