11111111111
11000000011
11000P01111
100001C1001
11000C00001
1C100000001
10000011111
11000000E11
11111111111