111111111111111111
10C0PC000E00111111
111111100C00001111
111111111110C01111
111111111110001111
111111111111111111
