111111
100001
1P0001
10E0C1
111111