1111111111111111111111111
1100000000000000000000011
11000P0000000000110001111
100001C10000000000C000001
11000C000001110000CC00001
1C10000000000111100000001
1C10000000000111100000001
1C10000000000111100000001
1C10000000000111100000001
1C10000000000111100000001
1C10000000000111100000001
1C10000000000111100000001
1C10000000000111100000001
1C10000000000111100000001
1C10000000000111100000001
1C10000000000111100000001
1C10000000000111100000001
1C00000000000111100000001
11000000E0000000000000011
1111111111111111111111111