1111111
1CCPCE1
1CCCCC1
1111111