1111111111111111111111111111111111111111
1100000000000000000000000000000000000001
11000P0000000000000000000000000000000001
100001C100000000000000000000000000000001
11000C0000011100011100011100011100011101
1C10000000000110000110000110000110000111
1C10000000000110000110000110000110000111
1C10000000000110000110000110000110000111
1C10000000000110000110000110000110000111
1C10000000000110000110000110000110000111
1C10000000000110000110000110000110000111
1C10000000000110000110000110000110000111
1C10000000000110000110000110000110000111
1C10000000000110000110000110000110000111
1C10000000000110000110000110000110000111
1C10000000000110000110000110000110000111
1C10000000000110000110000110000110000111
1C00000000000110000110000110000110000111
1C00000000000110000110000110000110000111
1C00000000000110000110000110000110000111
11000000E0000000000000000000000000000001
1111111111111111111111111111111111111111