111111111111111111
10C0P0C00100111111
111111101C10011111
111111111111C11111
111111011111E11111
111111111111111111
111111111111111111
