1111111111111111111111111111111111111111
110000000000000000000001000000000000C001
11000P00000000000000000E1000000000111111
100001C100000000000000010000000000000001
11000C0000011100011100011100011100011101
1C10000000000110000110000110000110000111
1C10000000000110000110000110000110000111
1C10000000000110000110000110000110000111
1C10000000000110000110000110000110000111
1C10000000000110000110000110000110000111
1C10000000000110000110000110000110000111
1C10000000000110000110000110000110000111
1C10000000000110000110000110000110000111
1C10000000000110000110000110000110000111
1C10000000000110000110000110000110000111
1C10000000000110000110000110000110000111
1C10000000000110000110000110000110000111
1C00000000000110000110000110000110000111
1C00000000000110000110000110000110000111
1100000000000000000000000000000000000001
1111111111111111111111111111111111111111