111111
100001
10P001
1000C1
1E0C01
111111