1111111
1C1P0C1
1C001E1
1111111